9x9* .12
****2****
*       *
*       *
*       *
*   1   *
*       *
*       *
*       *
****2****
